el aprendiz - learner

el aprendizaje - learning

la autoevaluación - self-assessment

el conocimiento - knowledge

el ensayo - essay

el error - mistake

el escritor - writer

el esfuerzo - effort

el esquema - outline

la estrategia - strategy

la explicación - explanation

el gesto - gesture

el hablante - speaker

el idioma - language

el lector - reader

la lectura - reading

la lengua extranjera - foreign language

la lengua materna - first language

la mayoría - majority

el mensaje - message

la minoría - minority

el nivel - level

la redacción - composition

la regla - rule

el sonido - sound

el trabajo escrito - paper

la traducción - translation

el alemán - German

el chino - Chinese

el coreano - Korean

el finlandés - Finnish

el francés - French

el griego - Greek

el hebreo - Hebrew

el holandés - Dutch

el japonés - Japanese

el ruso - Russian

el sueco - Swedish

el turco - Turkish

el vascuence - Basque 1

el euskera - Basque 2

apropiado(a) - adequate

bilingüe - bilingual

(la) clave - key

complejo(a) - complex

efectivo(a) - effective

escrito(a) - written

silencioso(a) - silent

acordarse (de) (o>ue) - to remember

adquirir (i>ie) - to acquire

animar - to encourage

aprovecharse de - to take advantage of

aumentar - to increase

cansarse - to get tired

callarse - to keep quiet

costar(le) (o>ue) (like gustar) - to find hard to

corregirse (e>i) - to correct oneself

darse cuenta de - to realize

desanimarse - to get discouraged

desarrollar(se) - to develop

descubrir - to discover

durar - to last

frustrarse - to get frustated

imitar - to imitate

involucrar - to involve

inscribirse - to enroll

mejorar - to improve

molestar (like gustar) - to bother

olvidarse de - to forget

perfeccionar - to perfect

preocupar - to worry

atentamente - attentively

efectivamente - exactly

esencialmente - essentially

indudablemente - certainly

oralmente - orally

actualmente - actually

cometer errores - to make mistakes

prestar atención - to pay attention

hacer esquemas - to prepare outlines

hacer preguntas - to ask questions

hacerse un lío - to get all mixed up

tener curiosidad - to be curious

darle miedo - to scare

estar dispuesto(a) - to be ready

la entrevista - interview

entrevistar - to interview

hablar con fluidez - to speak fluently

resultar(le) fácil - to come easily

tratar de - to try to

el hindi - Hindi

el árabe - Arabic

el italiano - Italian

caer bien/mal (le) - to like/not like someone

disgustar(le) - to dislike

doler (o>ue) (le) - to hurt

encantar(le) - to love

faltar(le) - to lack, be missing

fascinar(le) - to fascinate

gustar(le) - to like

importar(le) - to matter, be important to

interesar(le) - to interest

parecer(le) - to seem, appear

fastidiar(le) - to annoy, bother

resultar(le) - to turn out